1 1
6 6
######
#   ##
# #  #
# #  #
#   ##
######