1 4
6 7
#######
#  #  #
#  #E #
#  #  #
#  #  #
#######